########
##    ##
##. $ ##
# .#$###
# . $  #
##  @  #
########
